1111111111111
1000CC0001001
1110001000001
1000010100101
10P0100E00111
1111111111111